#############
#P....#.....#
#..##.#.E...#
#.....#.....#
#.E...###...#
#.......E...#
#...........#
#############
