###########
#P...#....#
#....#..E.#
#.........#
#..###....#
#..E......#
###########
